###############
......@...@....
...............
........@@.....
...............
.....@........@#
............@...
...............
..@...........#
.........@...##
...@......@####
####@##########