#####..@..#####
......@...@....
...............
...............
...............
.....@......@.@.
.....@......@...
...............
...............
...............
...............
####.##.@..####