######.@.######
......@...@....
...............
........@@.....
...............
.....@........@#
............@...
...............
...............
.....@.......##
...@.......####
####.##.@######